MMMMMMMMMMM,
MMMMOCPMPPM,
MMMMPMPPPPM,
MMMMPPPMPPM,
MOPPOPPMMPM,
MPCCMMMPPPM,
MPPPMMMPJPM,
MMMMMMMMMMM,
