MMMMMMMMMMM,
MMMMPPOMPPM,
MMMMPMPPJPM,
MMMMPCPMPPM,
MPPPPPPMMOM,
MCPPMMMPCPM,
MOPPMMMPPPM,
MMMMMMMMMMM,
