MMMMMMMMMMM,
MMMMJPPMPPM,
MMMMOMPPPPM,
MMMMPCPMPPM,
MPOPPPPMMOM,
MPPCMMMPCPM,
MPPPMMMPPPM,
MMMMMMMMMMM,
