MMMMMMMMMMM,
MMMMPPPMPPM,
MMMMOMPJPPM,
MMMMCPPMPPM,
MPPPPOPMMPM,
MPCPMMMPCOM,
MPPPMMMPPPM,
MMMMMMMMMMM,
