MMMMMMMMMMM,
MMMMPPPMPPM,
MMMMJMCPPOM,
MMMMCPPMPPM,
MPPOPPOMMPM,
MPCPMMMPCPM,
MPPOMMMPPPM,
MMMMMMMMMMM,
