MMMMMMMMMMM,
MMMMPPPMOPM,
MMMMPMPPCPM,
MMMMPPPMJPM,
MOPCPPPMMPM,
MOCPMMMPPPM,
MPPPMMMPPPM,
MMMMMMMMMMM,
