MMMMMMMMMMM,
MMMMPPOMPOM,
MMMMPMPPCPM,
MMMMPCPMPPM,
MPJPOPPMMPM,
MPCPMMMPPPM,
MPPPMMMPPPM,
MMMMMMMMMMM,
