MMMMMMMMMMM,
MMMMPJPMPPM,
MMMMPMPCPPM,
MMMMCPPMPOM,
MPCOPPOMMPM,
MPPPMMMPPPM,
MPPPMMMPPPM,
MMMMMMMMMMM,
