MMMMMMMMMMM,
MMMMPPPMPPM,
MMMMPMPPCPM,
MMMMPPCMOPM,
MPPOPPOMMPM,
MPPCMMMPPPM,
MPPPMMMPPJM,
MMMMMMMMMMM,
