MMMMMMMMMMM,
MMMMPPPMPPM,
MMMMPMOPPPM,
MMMMPPCMPPM,
MPPJPPPMMPM,
MPCOMMMPCPM,
MPPPMMMPPOM,
MMMMMMMMMMM,
