MMMMMMMMMMM,
MMMMPPPMPPM,
MMMMPMPCPOM,
MMMMCPPMPPM,
MPPOPJPMMPM,
MPPPMMMPCOM,
MPPPMMMPPPM,
MMMMMMMMMMM,
