MMMMMMMMMMM,
MMMMPPPMPOM,
MMMMOMPCPPM,
MMMMPCPMPPM,
MPJPCOPMMPM,
MPPPMMMPPPM,
MPPPMMMPPPM,
MMMMMMMMMMM,
