MMMMMMMMMMM,
MMMMPPOMPPM,
MMMMPMPPPPM,
MMMMJCPMPOM,
MPPPPOPMMPM,
MPPCMMMPCPM,
MPPPMMMPPPM,
MMMMMMMMMMM,
