MMMMMMMMMMM,
MMMMPPPMPPM,
MMMMCMPJPPM,
MMMMPPPMPPM,
MPOOCPPMMPM,
MPPPMMMOCPM,
MPPPMMMPPPM,
MMMMMMMMMMM,
