MMMMMMMMMMM,
MMMMPPPMPPM,
MMMMOMPCPPM,
MMMMCPPMPPM,
MPOPJCPMMPM,
MPPPMMMPPOM,
MPPPMMMPPPM,
MMMMMMMMMMM,
