MMMMMMMMMMM,
MMMMOPPMPJM,
MMMMCMPPPPM,
MMMMPPPMPPM,
MPPCPOPMMPM,
MPCPMMMPPPM,
MPPOMMMPPPM,
MMMMMMMMMMM,
