MMMMMMMMMMM,
MMMMPPPMPPM,
MMMMPMPCOPM,
MMMMPPPMPPM,
MPJPCOPMMPM,
MPCPMMMPPPM,
MPPOMMMPPPM,
MMMMMMMMMMM,
