MMMMMMMMMMM,
MMMMPPOMPPM,
MMMMOMPPPPM,
MMMMCCPMPPM,
MPPPOPPMMPM,
MPPCMMMJPPM,
MPPPMMMPPPM,
MMMMMMMMMMM,
