MMMMMMMMMMM,
MMMMPPPMPOM,
MMMMCMJCPPM,
MMMMPPPMPPM,
MOPOPPPMMPM,
MPCPMMMPPPM,
MPPPMMMPPPM,
MMMMMMMMMMM,
