MMMMMMMMMMM,
MMMMPPJMPPM,
MMMMPMCPPPM,
MMMMPPPMPPM,
MPPOPPOMMOM,
MPCPMMMPCPM,
MPPPMMMPPPM,
MMMMMMMMMMM,
