MMMMMMMMMMM,
MMMMPPPMPPM,
MMMMPMPPCPM,
MMMMCPPMPPM,
MJPPPOPMMOM,
MPCOMMMPPPM,
MPPPMMMPPPM,
MMMMMMMMMMM,
