MMMMMMMMMMM,
MMMMOPPMPPM,
MMMMPMPPPPM,
MMMMCPPMPOM,
MPJCOPPMMPM,
MPPPMMMPCPM,
MPPPMMMPPPM,
MMMMMMMMMMM,
