MMMMMMMMMMM,
MMMMPPOMPPM,
MMMMPMPPCPM,
MMMMPCPMPOM,
MPPCPOPMMPM,
MPPPMMMPPPM,
MPJPMMMPPPM,
MMMMMMMMMMM,
