MMMMMMMMMMM,
MMMMPPPMPPM,
MMMMOMPPPPM,
MMMMCCPMPPM,
MOPPPPPMMOM,
MPPPMMMPCPM,
MPJPMMMPPPM,
MMMMMMMMMMM,
