MMMMMMMMMMM,
MMMMOCPMPOM,
MMMMPMPPPPM,
MMMMPJPMPPM,
MPPOCPPMMPM,
MPPPMMMPCPM,
MPPPMMMPPPM,
MMMMMMMMMMM,
