MMMMMMMMMMM,
MMMMPPPMPPM,
MMMMPMPCPPM,
MMMMPCPMPPM,
MOPPJPPMMOM,
MPCOMMMPPPM,
MPPPMMMPPPM,
MMMMMMMMMMM,
