MMMMMMMMMMM,
MMMMPPPMPPM,
MMMMPMPPCOM,
MMMMCPJMPPM,
MPPPOOPMMPM,
MPPCMMMPPPM,
MPPPMMMPPPM,
MMMMMMMMMMM,
