MMMMMMMMMMM,
MMMMPPPMPPM,
MMMMPMPCPPM,
MMMMCPPMPPM,
MOPOJPPMMPM,
MCCPMMMPPPM,
MPOPMMMPPOM,
MMMMMMMMMMM,
