MMMMMMMMMMM,
MMMMPPPMPPM,
MMMMPMPPPJM,
MMMMPCPMPPM,
MPPPPOPMMPM,
MCPPMMMPCOM,
MOPPMMMPPPM,
MMMMMMMMMMM,
